11111X111111
10000000P111
1111110000C1
11100E000011
11111X111111
