1111111111111
1000PCE111112
1111111111111
