11111111111
1P000C00001
11111111111
