111111111111
10C000000E01
111111111111
