111111111
10P0C0E01
111111111
