1111111
10000C1
100P001
1E00001
1111111
