1111111111111111111111111111111111
1P10000C000000000100C0100001000001
1C00010111111001010000111011C00011
1011110100001001010000001110001001
1000C101000011C0011C01100010011001
101C11000C000000010001000011110001
1010000101111111110001001000100011
1C11100100000000010001011000101001
1010000111111111011011C10011101001
1010100C00000001001C10010010001111
101111110001000100101011E010000001
1CC0000111110101000010011111110101
1000100100010101011111111000000001
1111100C10010101C10000000001C01001
1C00000000000100000110001001001001
1111111111111111111111111111111111
