111111111111111111111111111111
10PC000000000100C0100001000001
110111111001010000111011C00011
110100001001010000001110001001
1101000011C0011C01100010011001
11000C000000010001000011110001
100101111111110001001000100011
100100000000010001011000101001
100111111111011011C10011101001
100C00000001001C10010010001111
11110001000100101011E010000001
100111110101000010011111110101
100100010101011111111000000001
100C10010101C10000000001C01001
100000000100000110001001001001
111111111111111111111111111111
