11111111
11101111
11PEC111
11101111
11111111
