11111111
11100111
11PEC111
11111111