11111111
11001X11
1ECP1111
11111111
