111111111
1111E0011
1100C0011
101001001
111111001
1P0001111
111111111
