1111111111
10E0010P11
11100C0011
1111111101
