111111111111111111111
111E00000000001000011
C00000100010010010000
P10101001010100010101
111111111111111111111
