11111111111
11110000011
111ECP11111
111111111111
