111111111
111PECP11
111111111
