11111111111111
1000E111111111
11000000001001
10000001000011
10010000001001
11111000P00001
10000000000001
10000000000011
11111111111111
